Dieses	PDAT	dies
Handy	NE	Handy
ist	VAFIN	sein
absolut	ADJD	absolut
empfehlenswert	ADJD	empfehlenswert
.	$.	.
Sehr	ADV	sehr
leichte	ADJA	leicht
Bedienung	NN	Bedienung
und	KON	und
sieht	VVFIN	sehen
auch	ADV	auch
noch	ADV	noch
top	ADJD	<unknown>
modisch	ADJD	modisch
aus.Akkulaufzeit	NN	<unknown>
wie	KOKOM	wie
beschrieben	VVPP	beschreiben
.	$.	.
Es	PPER	es
gibt	VVFIN	geben
keinerlei	PIAT	keinerlei
Beanstandungen	NN	Beanstandung
